NO ./textures/texture_no.xpm
SO ./textures/texture_so.xpm
WE ./textures/texture_we.xpm
EA ./textures/texture_ea.xpm

C 50 50 50
F 200 200 200

111111111111111
100000000000001
100000000000001
100000000000001
100000000000001
100000000000001
100001010000001
100000000000001
100000101000001
1000000E0000001
100000101000001
100000000000001
100000000000001
100000000000001
111111111111111
