NO ./textures/texture_no.xpm
SO ./textures/texture_so.xpm
WE ./textures/texture_we.xpm
EA ./textures/texture_ea.xpm

C 50 50 50
F 200 200 200

1111111111
1000000111
11110011
1000000111
10000N000111111
1000000001
1111111111
