NO ./textures/texture_no.xpm
SO ./textures/texture_so.xpm
WE ./textures/texture_we.xpm
EA ./textures/texture_ea.xpm

C 50 50 50
F 200 200 200

111111111111111111111111
100000000000000000000001
100000000000000000000001
100000000000000000000001
10000000000000000P000001
100000000000000000000001
1000P0000000011111D11111
100000000000100000000001
100000000P000111111D1111
100000000000011000000001
100000000000000000000001
10000000000N000000000001
100000000000001000000001
111111111111111111111111
100000000000000000000001
100000000000000000000001
100000000000000000000001
100000000000000000000001
100000000000000000000001
100000000000000000000001
100000000000000000000001
100000000000000000000001
111111111111111111111111
