NO ./textures/wall1.xpm
SO ./textures/wall2.xpm
WE ./textures/wall3.xpm
EA ./textures/wall4.xpm

C 50 50 50
F 200 200 200

111111111111111111111111
100000000000000000000001
100000000000000000000001
10000000000P000000000001
10000000000000000P000001
100000000000000000000001
1000P0000000011111D11111
100000000000100000000001
100000000P000111111D1111
10000N00000P011111111111
100000000000101
10000000P000011111111111
111111000000001000000001
      111110111111111111
111111111110111111111111
100000000000000000000001
1000000000000000000000011111111111111111111111111111111111111111111111111111111111111111111111111111111111111111111111111111111111111111111111111111111111111111111111111111111111111111111111111111111111111111111111111111111111111111111111111111111111111111111111111
1000000000000000000000000000000000000000000000000000000000000000000000000000000000000000000000000000000000000000000000000000000000000000000000000000000000000000000000000000000000000000000000000000000000000000000000000000000000000000000000000000000000000000000000001
10000000000P0000000000011111111111111111111111111111111111111111111111111111111111111111111111111111111111111111111111111111111111111111111111111111111111111111111111111111111111111111111111111111111111111111111111111111111111111111111111111111111111111111111111111
100000000000000000000001
100000000000000000000001
10000P000000000000000001
100000000000000000000001
111111111111111111111111
